1 1 1 1 1 1 1
1 P 0 C 0 0 1
1 0 0 0 0 0 1
1 0 0 0 0 E 1
1 1 1 1 1 1 1
