1111111111111111111111
1001000100000000000011
1111000000000011100001
1101110000000011100001
1101000000000010100001
1101000001100011100001
1000000000000000000011
10000000PCE00000000001
1000000010010000000011
1000010000000010000001
1000010000100001000001
1000000010010000000001
1111111111111111111111
1000000001100000000001
1001000001100000100001
1001000000000000100011
1001110000000011100011
1000000100000000100011
1000000000000000000001
1111111111111111111111
